NO /nfs/homes/about/Documents/cub2/textures/grass.xpm
SO /nfs/homes/about/Documents/cub2/textures/sand.xpm
WE /nfs/homes/about/Documents/cub2/textures/stone.xpm
EA /nfs/homes/about/Documents/cub2/textures/wood.xpm
F 220,100,0
C 225,30,0

11111111111111111
10000000000000001
10000011101111111
1000000000001
111111111100111
111110000000001
1100000W0000001
111111111111111
