NO ./textures/wall4.xpm
SO ./textures/wall3.xpm
WE ./textures/wall2.xpm
EA ./textures/wall1.xpm

C 12,15,155
F 100,100,50


1111111111111111111111111111111111111
1000001110000000000000000000000011111
1000001 10000000000000000000000000001
1000001110000000111111111111111111111
10000011101111111
1000000000001
111111111100111111111111111
111110000000000000000000001
1100000W0000000000000000001
111111111111111111111111111