NO ./textures/1.xpm
SO ./textures/2.xpm
WE ./textures/3.xpm
EA ./textures/4.xpm
F 100,100,85
C 15,12,5

1111111111111111111111111111111111111
1000001110000000000000000000000011111
1000001 10000000000000000000000000001
1000001110000000111111111111111111111
100000111D1111111
1000000000001
111111111100111111111111111
111110000000000000000000001
1100000W0000000000000000001
111111111111111111111111111