NO ./textures/alae5.xpm
SO ./textures/alae6.xpm
WE ./textures/alae7.xpm
EA ./textures/alae8.xpm
F 100,100,85
C 15,12,0

        11111111111111111111111111111111111111
        1000001110000000000000000000000011111
1111111 100000000000000000000000000011111111
1000001110000000111111111111111111111
100000111001111111
1000000000001
111111111100111111111111111
111110000000000000000000001
1100000W0000000000000000001
111111111111111111111111001
110000000000011  1000000001
100000000000001111000000001
110000000000000000000000001
111111111111111111111111111
