NO ./textures/5.xpm
SO ./textures/6.xpm
WE ./textures/7.xpm
EA ./textures/8.xpm
C 15,20,150
F 100,100,50

          1111111111111111111111111111111111111
          1000001110000000000000000000000011111
1111111   100000000000000000000000000011111
100000111110000011111111111111111111111
1000001110000111111100000000001111111111
1111000000000000000000000011111
110000000000000000000000001
1111111111111111111111D1111
100000000000000000000000001
1111111111D111111111111111111111
     1111100000000000000000000011111111111111
        11111111111100000N0000000000000000001
        1111111111111111111111111111111111111