NO ./textures/grass.xpm
SO ./textures/sand.xpm
WE ./textures/stone.xpm
EA ./textures/wood.xpm
C 15,20,150
F 100,100,50

111111111111111111111111111111111111111111111111111111111111111111111111111111111111111
10000000000000000000100000000000000000000000000000000000000000000000000000000011111111
1000000000100000001000000000000W0000D00000000000000000000000000000000000000000000000011
10000000010000000001000000000000000000000000100000000000000000000000000000000000000001
111111111110111111111000011110000010000000000100000000000000000000000000000000000000001
100000000000000000001000011000001000000000010000000000000000000000000000000000000000111
1000000000000000000010000110000010000000000100000000000000000000000000000000011111111
1000000000000000000010000110000010000000000100000000000000010000000000000000000000001
1000000000000000000010000111100000100000000001000000000000000000000000000000000111111
10000000000000000000100000000000001000000000010000000000000000000000000000000001101
111111100000000000001000000000000010000000000100000000000000000000000000000000011111111
      100000000000000000001111111111D11110000000000000000000000000000000000000000000001
111111100000000000000100000000000010000000000000000000000000000000000000000000011111111
100000000100000000000000000000000000000000000000000000000000000000000000000000011111111
100000000100000000000000000000000000000000000000000000000000000000000000000000011111111
100000000100000000000000000000000000000000000000000000000000000000000000000000011111111
100000000100000000000000000000000000000000000000000000000000000000000000000000011111111
100000000100000000000000000000000000000000000000000000000000000000000010000000000000001
100000000100000000000000000000000000000000000000000000000000000000000000000000000000001
100000000100000000000000000000000000000000000000000000000000000000000000000000011111101
100000000000111100000000000000000000000000000000000000000000000000000000000000000000001
100000000000111100000000000000000000000000000000000000000000000000000000000000011111111
100000000100100000000000000000000000000000000000000000000000000000000000000000011111111
100000000100100000000000000000000000000000000000000000000000000000000000000000011111111
100000000100100000000000000000000000000000000000000000000000000000000000000000011111111
100000000100100000000000000000000000000000000000000000000000000000000000000000011111111
100000000100100000000000000000000000000000000000000000000000000000000010000000111111111
100000000100100000000000000000000000000000000000000000000000000000000000000000111111111
100000000000100000000000000000000000000000000000000000000000000000000000000000111111111
100000000111000000000000000000000000000000000000000000000000000000000000000000011111111
100000000111111111100000000000000000000000000000000000000000000000000000000000011111111
100000000000000000111111110000000000000000000000000000000000000000000000000000011111111
100000000000000000000000010000000000000000000000000000000000000000000000000000011111111
100000000111111111111111110000000000000000000000000000000000000000000000000000011111111
100000000100000000000000000000000000000000000000000000000000000000000010000000111111111
100000000100000000000000000000000000000000000000000000000000000000000000000000111111111
100000000100000000000000000000000000000000000000000000000000000000000000000000111111111
100000000101111100000000000000000000000000000000000000000000000000000000000000011111111
100000000100000000000000000000000000000000000000000000000000000000000000000000011111111
100000000100000000000000000000000000000000000000000000000000000000000000000000011111111
100000000100000000000000000000000000000000000000000000000000000000000000000000011111111
100000000100000000000000000000000000000000000000000000000000000000000000000000011111111
100000000100000000000000000000000000000000000000000000000000000000000010000000111111111
100000000100000000000000000000000000000000000000000000000000000000000000000000111111111
100000000100000000000000000000000000000000000000000000000000000000000000000000111111111
100000000101111100000000000000000000000000000000000000000000000000000000000000011111111
100000000100000000000000000000000000000000000000000000000000000000000000000000011111111
100000000100000000000000000000000000000000000000000000000000000000000000000000011111111
100000000100000000000000000000000000000000000000000000000000000000000000000000011111111
100000000100000000000000000000000000000000000000000000000000000000000000000000011111111
100000000100000000000000000000000000000000000000000000000000000000000010000000111111111
100000000100000000000000000000000000000000000000000000000000000000000000000000111111111
100000000100000000000000000000000000000000000000000000000000000000000000000000111111111
1000000000000000000010000110000010000000000100000000000000010000000000000000000000001
1000000000000000000010000111100000100000000001000000000000000000000000000000000111111
10000000000000000000100000000000001000000000010000000000000000000000000000000001101
1111111000000000000010000000000000100000000001000000000000000000000000000000000111111111
11111111111111111111111111111111111111111111111111111111111111111111111111111111111